****************
*           ****
*     B B B ****
*    ***********
*    DddD I    *
*    DddD     !*
*    DddD      *
*    ***********
*     B B B ****
*           ****
****************