******************
*****        *****
*****        *****
*   F  B  C  *****
*   F        *****
*   F  _  _  *****
*****        *****
*****        *****
*******    *******
*******FFFF*******
*******    *******
*****_d    FC*****
****BDd    F B****
*****_d    FB*****
*******    *******
*******FFFF*******
*****CD      D   *
***** D      D ! *
*****BD      D   *
********_ _ _*****
******************