******************
*      *     *****
* _  C D   B *****
*      *     *****
***DD*************
*      *     *I  *
*    B F   _ D ! *
*      *     *   *
******************