****************************************
**********          !         **********
*****                              *****
****                               *****
***                                *****
*                                  *****
*                                  *****
***                                *****
*****                            *******
******                         *********
********                      **********
**********                    **********
************                 ***********
************                ************
*************            ***************
**************          ****************
***************        *****************
***************        *****************
***************   I   ******************
************          ******************
***********           ******************
**********             *****************
*******               ******************
*******          ***********************
*****        ***************************
***       ******************************
***     ********************************
**     *********************************
*    ***********************************
*    ***********************************
*   ************************************
****************************************