**********************
*           I  *******
*              *******
*  dddddd      *******
*  d    d      d B ***
*  d    d   B  d   D!*
*  d    d      d   ***
*  dddddd      *******
*              *******
*              *******
**********************